11111111111111111
10000000100000001
10000002220000001
10000033333000001
10000444444400001
10005555555550001
10066666666666001
10777777777777701
11111111111111111