33333333333333333
33333333333333333
00000003330000000
11111103330111111
11111100000111111
11111111111111111
11111100000111111
11111103330000000
00000003330000000
33333333333333333
33333333333333333
