11111111111111111
11111100000111111
22220022222002222
33220033333002233
22220022222002222
33220033333002233
11111100000111111
11111111111111111