11111111111111111
12222222133333331
12222222133333331
12222222133333331
12222222133333331
11111111111111111
14444444155555551
14444444155555551
14444444155555551
14444444155555551
11111111111111111