33003333333330033
30000333333300003
30000333333300003
11001111111110011
11100111111100111
11110011111001111
11111001110011111
33003333333330033

