55555555555555555
55555555555555555
66660000000006666
66660000000006666
66660007770006666
66660007770006666
66660007770006666
66660000000006666
66660000000006666
55555555555555555
55555555555555555